山东=SHD
江苏=JSU
安徽=ANH
浙江=ZHJ
福建=FUJ
上海=SHA
广东=GUD
广西=GUX
海南=HAN
湖北=HUB
湖南=HUN
河南=HEN
江西=JIX
北京=BJI
天津=TIJ
河北=HEB
山西=SHX
内蒙古=NMG
宁夏=NIX
新疆=XIN
青海=QIH
陕西=SXI
甘肃=GAS
四川=SIC
云南=YUN
贵州=GZH
西藏=XZA
重庆=CHQ
辽宁=LIN
吉林=JIL
黑龙江=HLJ
台湾=TWA
香港=HKG
澳门=AOM